1111111111111111111111
1P00000000001000000001
10000C0000000000000011
1000000000010000000001
1111111111111000000001
1C00000000000000000001
10000C0000000000000001
1000000000100000111111
1111100001C1000E000001
110C000000100000000C01
1111111111111111111111