1111111111111111111111
1P00000000001000000001
1000NCN000000000N00011
10000N0000010000000001
1111111111111000000001
1C00000000000000000001
10000C000000000N000001
1000000000000000111111
1111100001C100NE000001
110C00N000100000000C01
1111111111111111111111