1111111111111
1P00000000001
10000C0000001
10000000000E1
1111111111111