1111111111111
1000000000001
10001C1000C01
1000P1000J1E1
1111111111111
