1111111111111111111111111111111111111111111111111111
1P00000000000000000000000000000000000000000000000001
10000C0000001111111111111100000000000000000000000001
10000000000E1111111111111100000000000000000000000001
1111111111111111111111111111111111111111111111111111
