1111111111111111111111
1P00000000001000000001
10000CN000000000N11111
1000000000010000000001
111111111111100000C101
1C00000100000010000011
10010C000NNNNN0N001E01
1111111111111111111111
